79
X E 0 0 0
X 0 0 0 0
0 0 0 0 X
S 0 0 0 X
0 0 0 X 0
1 3
2 0
10
1
28
25
22
19
16