73
0 S 0 X 0
0 0 0 0 0
0 0 0 0 0
0 0 0 0 X
0 0 0 0 E
1 3
2 1
10
5
21
18
15
12
9