9
0 0 E 0 0
0 0 0 0 0
0 0 0 X 0
0 0 X X 0
S 0 0 0 X
2 2
1 0
5
6
24
21
18
15
12
