82
0 0 0 0 0
0 0 X 0 0
0 X 0 0 0
0 0 0 0 0
S 0 0 0 E
2 1
2 0
9
6
32
29
26
23
20