71
X 0 X E 0
0 0 0 0 0
0 0 0 0 0
0 X 0 X 0
S 0 0 0 0
2 0
2 0
6
6
30
27
24
21
18