32
0 0 0 0 0
X 0 0 0 0
0 0 0 0 0
S 0 0 0 E
0 0 0 0 X
2 1
2 1
12
3
33
30
27
24
21