62
E 0 0 0 0
0 0 0 0 X
0 0 0 X 0
S 0 0 X 0
0 0 0 0 0
2 1
2 1
6
4
21
18
15
12
9