95
0 0 S E 0
0 0 X 0 0
0 0 X 0 0
0 0 0 0 0
0 0 0 0 0
1 3
1 0
14
4
40
37
34
31
28