6
S 0 0 0 0
0 0 0 0 0
0 0 0 0 0
0 0 0 0 0
0 0 0 0 E
2 0
2 0
8
15
21
18
15
12
9