90
0 0 E 0 0
X 0 0 0 0
0 0 0 0 0
0 0 0 0 0
X S 0 0 0
2 0
1 0
9
7
21
18
15
12
9