17
0 0 0 0 X
S X 0 0 0
0 0 0 0 0
0 0 X 0 E
0 0 0 0 0
1 3
1 1
8
7
21
18
15
12
9