27
0 0 S 0 0
0 0 0 0 E
X 0 X 0 X
0 0 0 0 0
0 0 0 0 0
2 0
1 0
8
4
27
24
21
18
15
