54
0 X 0 0 0
S 0 0 0 0
0 0 0 0 0
0 0 0 X 0
0 E 0 0 0
2 1
1 1
6
9
27
24
21
18
15