48
S 0 X 0 E
0 0 0 0 0
0 0 0 0 0
0 X 0 0 X
0 0 0 0 0
2 0
2 0
12
3
33
30
27
24
21