70
0 X 0 0 0
0 0 0 0 0
S 0 X 0 0
0 0 0 0 0
E 0 0 0 0
2 1
1 0
13
4
21
18
15
12
9