39
X S 0 0 0
0 0 0 0 0
0 0 0 X 0
0 0 0 0 0
E 0 0 X 0
2 0
1 3
8
6
29
26
23
20
17