88
S 0 0 X E
X 0 0 0 0
0 X 0 0 0
X 0 0 0 0
0 0 0 0 0
2 1
1 1
9
4
36
33
30
27
24