87
0 0 0 X E
0 0 0 X 0
0 X 0 0 0
0 0 X 0 S
0 0 0 0 0
2 1
2 0
9
5
21
18
15
12
9