23
X E 0 0 0
0 X 0 0 0
0 0 0 0 0
0 X 0 X 0
X S 0 0 X
1 1
1 0
4
5
24
21
18
15
12
