76
0 0 0 0 0
0 0 0 0 0
0 0 0 X 0
S 0 0 0 0
0 0 E 0 X
2 1
2 0
9
7
35
32
29
26
23