54
0 X 0 0 0
S 0 0 0 0
0 0 0 0 0
0 0 0 X 0
0 E 0 0 0
2 1
1 2
6
8
21
18
15
12
9