22
X X X X X
0 0 0 0 0
S 0 0 0 E
0 0 0 0 0
X X X X X
2 1
1 0
7
2
27
24
21
18
15