91
0 0 0 0 0
0 0 0 0 0
0 0 X 0 0
0 0 X 0 0
0 S 0 X E
2 0
2 0
8
4
21
18
15
12
9