65
0 0 0 E 0
X 0 0 X 0
0 0 0 0 0
0 0 0 0 0
S 0 0 0 X
2 0
1 0
9
5
32
29
26
23
19