89
S 0 0 0 0
X 0 0 0 0
0 0 0 X 0
0 0 X 0 0
E 0 0 0 0
1 0
1 1
6
7
32
29
26
23
20