11
X 0 0 0 X
0 0 0 0 0
S 0 0 0 E
0 0 0 0 0
X 0 0 0 X
2 1
2 3
6
1
24
21
18
15
12