78
0 0 X 0 0
0 0 0 0 0
X 0 0 0 0
0 0 0 0 X
S 0 0 0 E
2 0
2 1
9
4
21
18
15
12
9