34
X 0 0 0 0
0 0 0 X 0
S 0 0 0 0
0 X X 0 0
0 0 0 E X
2 1
2 0
7
1
22
19
16
13
10