2
S X X X X
0 X X X X
0 X X X X
0 X X X X
0 0 0 0 E
2 0
2 1
1
6
21
18
15
12
9