88
S 0 0 X E
X 0 0 0 0
0 X 0 0 0
X 0 0 0 0
0 0 0 0 0
2 0
1 1
9
4
21
18
15
12
9