29
0 S 0 0 0
0 X 0 0 0
0 0 X 0 0
0 0 0 0 0
E 0 X 0 0
1 0
2 0
9
3
27
24
21
18
15
