51
S 0 0 0 X
0 X 0 0 0
0 0 0 X 0
0 X 0 0 0
0 0 0 0 E
2 1
1 2
8
5
30
27
24
21
18