59
0 0 0 X 0
0 0 0 0 0
0 X 0 0 0
0 0 0 0 0
0 S E 0 0
2 0
2 0
8
6
33
30
27
24
21