50
0 0 0 0 X
0 0 0 0 0
S 0 X 0 0
X 0 0 0 0
0 E 0 0 0
2 1
2 0
5
9
21
18
15
12
9