80
E 0 0 0 0
0 0 0 X 0
0 0 0 0 0
0 0 0 0 X
0 S 0 X 0
2 0
2 0
6
8
21
18
15
12
9