56
0 S 0 0 0
X 0 0 0 0
0 0 0 X 0
0 0 0 0 0
0 E 0 0 0
2 0
2 0
6
7
35
32
29
26
23