80
E 0 0 0 0
0 0 0 X 0
0 0 0 0 0
0 0 0 0 X
0 S 0 X 0
2 0
2 0
8
6
32
29
26
23
20