55
S 0 0 X 0
0 0 0 0 0
0 0 0 0 0
0 0 0 0 0
0 0 X 0 E
2 0
2 0
6
7
25
22
19
16
13