96
S 0 0 X 0
0 0 0 0 0
0 0 X 0 0
0 0 0 0 0
0 0 E 0 0
1 2
2 0
10
7
35
32
29
26
23