14
0 0 0 S E
0 0 0 X 0
0 0 X 0 0
0 0 0 0 X
X 0 0 0 0
1 3
2 2
7
3
21
18
15
12
9