3
S 0 0 0 X
0 X 0 0 0
0 0 X 0 0
0 0 0 X 0
X 0 0 0 E
2 1
2 0
5
2
21
18
15
12
9