62
E 0 0 0 0
0 0 0 0 X
0 0 0 X 0
S 0 0 X 0
0 0 0 0 0
2 1
2 1
6
4
26
23
20
17
14