8
0 0 0 0 0
X 0 X 0 0
0 0 0 0 X
0 0 X 0 0
0 S X E 0
1 2
1 1
8
5
27
24
21
18
15