24
X 0 0 X 0
S 0 0 0 X
X 0 0 0 0
0 0 0 0 0
X 0 0 E X
2 1
2 0
7
2
24
21
18
15
12