1
S 0 0 X 0
0 0 X 0 0
0 0 0 0 0
0 X 0 0 0
X 0 0 0 E
2 0
2 3
5
4
28
26
24
22
20