52
0 0 0 0 0
S 0 0 0 0
X X 0 0 0
E 0 0 0 0
0 0 0 0 0
1 3
1 2
18
1
21
18
15
12
9