12
S 0 0 0 X
0 0 0 0 0
0 0 0 X E
0 X 0 0 0
0 0 0 0 0
2 0
1 0
8
7
31
28
25
22
19