64
S 0 0 X X
0 0 0 0 X
0 0 0 0 0
X 0 0 0 0
X X 0 0 E
2 0
2 0
8
3
26
23
20
17
14