92
0 E 0 0 0
X X 0 X 0
0 0 0 0 0
0 X 0 0 0
S 0 0 0 0
2 0
1 0
5
9
21
18
15
12
9