30
S 0 0 0 0
0 0 0 0 0
0 X 0 0 0
0 0 0 0 0
0 0 0 0 E
2 1
2 1
8
9
31
28
25
22
19