70
0 X 0 0 0
0 0 0 0 0
S 0 X 0 0
0 0 0 0 0
E 0 0 0 0
2 1
1 1
13
4
36
33
30
27
24
