1
X X S X X
X X 0 X X
X X 0 X X
X X 0 X X
X X E X X
2 0
2 0
0
3
15
12
9
6
3