18
0 0 0 0 0
0 0 X 0 0
0 X 0 0 0
0 0 0 0 0
S E 0 X 0
2 0
2 2
8
6
21
18
15
12
9