49
X E 0 0 0
0 0 0 X 0
0 0 0 0 0
0 0 0 0 0
0 0 0 0 X
2 0
1 0
9
3
21
18
15
12
9