79
X E 0 0 0
X 0 0 0 0
0 0 0 0 X
S 0 0 0 X
0 0 0 X 0
1 3
2 0
10
1
21
18
15
12
9