67
0 0 0 0 0
0 0 0 0 0
0 0 0 0 X
0 0 0 0 E
S X 0 0 0
2 0
2 1
11
5
30
27
24
21
18