15
S 0 0 X X
0 0 0 0 0
0 0 0 0 0
0 0 0 0 0
X 0 0 0 E
2 0
2 0
10
1
24
21
18
15
12
