40
0 0 0 0 0
S 0 X 0 0
0 0 0 X 0
0 0 0 0 E
X 0 0 0 0
1 3
2 1
9
2
27
24
21
18
15
