num
0 0 0 0 S
0 0 0 0 0
X 0 0 0 0
0 0 0 0 0
X 0 E 0 0
2 0
2 0
8
7
21
18
15
12
9