7
0 0 0 0 E
0 X 0 0 0
S X 0 0 X
0 0 0 0 0
0 0 0 0 0
1 2
1 3
9
4
32
29
26
23
20