41
0 E X 0 X
0 0 0 0 0
0 0 0 0 0
X 0 0 0 0
S 0 0 0 0
2 1
2 0
9
5
30
27
24
21
18