49
X E 0 0 0
0 0 0 X 0
0 0 0 0 0
0 0 0 0 0
S 0 0 0 X
2 0
1 0
9
3
29
26
23
20
17