35
0 0 S 0 0
0 0 0 0 X
0 0 X 0 0
0 0 0 0 0
0 0 0 E 0
2 0
2 0
8
2
27
24
21
18
15