13
X 0 0 0 E
0 X 0 0 0
0 0 X 0 0
S 0 0 0 0
0 0 0 0 0
1 3
1 1
12
0
33
30
24
21
18