69
0 S 0 0 X
0 0 0 0 0
0 0 0 0 0
X 0 X 0 0
0 E 0 0 0
2 0
1 1
5
4
24
21
18
15
12