55
S 0 0 X 0
0 0 0 0 0
0 0 0 0 0
0 0 0 0 0
0 0 X 0 E
2 0
2 0
6
6
21
18
15
12
9