16
0 0 E 0 0
0 X X 0 0
0 0 0 0 0
X X 0 0 0
S 0 0 0 0
2 1
1 0
8
3
30
27
24
21
18