81
0 0 0 0 S
0 0 0 0 0
0 0 0 0 X
0 0 X X 0
0 0 E 0 0
2 0
1 2
9
4
33
30
27
24
21