68
X 0 E 0 0
X X 0 0 0
0 0 0 0 0
0 0 0 0 0
S 0 0 0 0
2 1
1 0
10
6
21
18
15
12
9