50
0 0 0 0 X
0 0 0 0 0
S 0 X 0 0
X 0 0 0 0
0 E 0 0 0
2 1
2 0
9
5
34
31
28
25
22