25
S 0 0 X 0
0 0 X 0 0
0 0 0 0 0
0 X 0 0 0
X 0 0 0 E
2 0
2 1
5
4
24
21
18
15
12