85
S X 0 0 X
0 0 0 0 0
0 X 0 0 0
0 0 0 0 E
X 0 0 0 0
2 0
2 1
7
3
27
24
21
18
15