31
0 0 0 S 0
X 0 0 0 E
0 0 0 X 0
0 0 0 0 0
0 0 0 0 0
2 0
1 1
10
3
33
30
27
24
21