94
S 0 0 X 0
0 0 X 0 E
X 0 0 0 0
X 0 0 0 0
0 0 0 0 0
2 0
1 1
8
4
31
28
25
22
19