42
X 0 0 X X
0 0 0 0 0
X 0 0 0 X
0 0 0 0 0
0 S 0 0 E
2 0
1 2
7
3
30
27
24
21
18