84
0 0 0 0 E
0 0 0 0 X
0 0 0 0 0
X X X X 0
S 0 0 0 0
1 1
2 1
8
9
21
18
15
12
9