75
0 0 0 0 S
0 0 0 0 0
X 0 0 0 0
0 0 X 0 0
0 0 0 0 E
2 0
2 0
12
7
40
37
34
31
28