36
0 0 X 0 S
0 0 0 0 0
0 X 0 0 X
0 0 0 0 0
0 0 0 0 E
2 0
1 2
9
4
27
24
21
18
15