61
S X 0 0 X
0 0 0 0 E
0 X 0 0 X
0 0 0 0 0
0 0 0 0 0
2 0
2 1
7
7
34
31
28
25
20