37
0 0 S 0 0
0 0 0 X 0
0 X 0 0 0
0 X 0 0 E
0 0 0 X 0
1 3
2 1
6
6
30
27
24
21
18