47
S 0 X 0 0
0 0 0 0 0
0 0 0 0 0
0 0 0 0 X
0 X 0 0 E
2 0
2 1
9
4
33
30
27
24
21