45
0 S X 0 0
0 0 0 0 X
0 0 0 0 0
E 0 X 0 0
0 0 0 0 0
2 0
2 1
11
4
33
30
27
24
21
