77
0 S 0 0 0
0 0 0 X 0
0 0 X 0 0
0 0 0 0 0
0 0 0 0 E
1 3
1 2
10
8
21
18
15
12
9