72
0 S 0 0 0
0 0 X 0 0
0 0 0 0 0
0 0 0 0 0
0 0 X X E
2 0
2 0
8
3
21
18
15
12
9