20
0 0 0 0 E
S 0 0 0 X
0 0 0 0 0
0 X 0 0 0
0 0 0 0 0
2 1
2 1
8
6
21
18
15
12
9