5
0 0 0 0 S
0 0 0 0 0
0 0 0 0 0
0 0 0 0 0
0 0 0 0 E
2 0
2 0
4
7
21
18
15
12
9