58
0 0 0 0 0
0 0 0 0 0
0 0 0 0 0
0 X X 0 0
S 0 E 0 0
2 0
1 1
9
6
32
29
26
23
20