38
0 0 0 0 X
S 0 0 0 X
0 X 0 0 0
X 0 0 0 0
0 0 E 0 0
2 1
1 1
8
4
27
24
21
18
15