44
0 X 0 E 0
0 0 0 0 0
X 0 0 X 0
S 0 0 0 0
0 0 0 0 X
2 1
1 0
8
3
32
29
26
23
20