66
0 0 0 0 X
0 0 0 0 0
0 0 0 0 0
S 0 X 0 0
0 0 E 0 0
1 2
1 1
15
3
37
34
31
28
25