43
X 0 X 0 0
S 0 0 0 0
0 0 0 X 0
0 0 0 0 0
0 0 E 0 0
2 1
1 1
10
6
32
29
26
23
20