28
0 0 0 X 0
0 X 0 0 0
0 0 0 0 0
S 0 0 0 0
0 0 0 0 E
2 3
2 0
7
5
33
30
27
24
21