83
0 0 X 0 0
E 0 0 0 0
X X 0 0 0
0 0 0 0 0
S 0 0 0 0
2 0
2 1
11
3
39
36
33
30
27