61
S X 0 0 X
0 0 0 0 E
0 X 0 0 X
0 0 0 0 0
0 0 0 0 0
2 0
2 0
7
7
21
18
15
12
9