26
X 0 0 0 0
X 0 0 X E
0 0 0 0 0
0 0 0 X 0
S 0 0 0 0
2 2
1 0
8
6
33
30
27
24
21