86
S X 0 0 X
0 0 X 0 0
0 0 0 0 0
0 X X 0 0
0 0 0 0 E
2 0
2 0
8
3
25
22
19
16
13