46
0 0 0 0 0
0 X 0 X 0
0 0 0 0 0
S X 0 0 0
0 E 0 0 0
1 3
1 1
9
6
36
33
30
27
24