4
S 0 0 0 0
0 0 0 0 0
0 0 0 0 0
0 0 X X 0
0 X E 0 0
2 0
1 1
3
6
24
21
18
15
12