60
X 0 0 0 0
0 0 0 0 0
0 0 0 X 0
0 0 X 0 0
0 0 S E 0
1 2
2 0
11
3
21
18
15
12
9