10
0 0 S X 0
0 0 0 0 0
0 0 0 0 X
0 0 0 0 0
0 0 0 0 E
1 3
1 0
11
8
40
37
34
31
28