77
0 S 0 0 0
0 0 0 X 0
0 0 X 0 0
0 0 0 0 0
0 0 0 0 E
1 3
1 2
10
8
33
30
27
24
21