68
X 0 E 0 0
X X 0 0 0
0 0 0 0 0
0 0 0 0 0
S 0 0 0 0
2 1
1 0
10
7
36
33
30
27
23